19 20
g g g g g g g g g g g g g g g g g g h g g
g g g g g g g p p p p g g g g g g h g g 
g g g g g g g p g g p g g g g g g g g l 
m g g m g g g p p p p g g m g g g g g g 
g g g g g g h g g g g g g g g g h g g g
z n n n n n n n n n n n n n n n n x g 
g w p p p p p p p p p p p p p p p p e g 
g w p p p p p p p p p p p p p p p p e g 
g w p p p p p p p p p p p p p p p p e g 
g c s s s s s s s s s s s s s s s s v g  
g h g g g g g l g h g h g g g g g l g h 
g g g g g g g g h g g g g g g g g g h g g 
z n n n n n n n n n n n n n n n n x g 
g w p p p p p p p p p p p p p p p p e g 
g w p p p p p p p p p p p p p p p p e g 
g w p p p p p p p p p p p p p p p p e g 
g c s s s s s s s s s s s s s s s s v g
g g g g g g g g g l g g g g g g g g g l 
g g g m g g g g g g g g g m g g g g g g 
g g g g g g h g g g m g g g g g h g g g 
g h g g g g g l g g g h g g g g g l g g 